20 20 250
RXXXXXXXXXXXXXXXXBBB
B..........H........
.XXXXXXX..XX.....XXX
.XXXXXXXXXXX......XX
B..........E......XX
XXX..XXBXXXC......F.
.XXXXXXXXXXX......X.
B.................B.
XXXXXXXXXXXC......XX
....................
XXXXX......XXXX.....
....................
....................
XX..................
XX....XXXXXXXXXXBBBX
XX.BXXXXXXXXXXXXXBXX
XX.XBXXXXXXXXXXXBBBX
XXcXcC...........F..
XX.BXXXXXXXXXXXXXXXX
XX.BXXXXX...........
